    1111111111111
    1N00000001001
    1000000001001
    1001110001001
    1000000000001
    1000000000001
    1000000000001
    1000000000001
    1111111111111
